00000000000000000000
00000000000000000000
00000000000000000000
00000000000000000000
00000000000000000000
00000000000000011110
00000000000000000000
00000001111111111110
00000000000000000000
00011111111111111110
00000000000000000000
01111111111111111110
00000000000000000000
01111111111111111110
00000000000000000000
01111111111111111110
00000000000000000000
01111111111111111110
00000000000000000000
01111111111111111110
