0000000000000000000000000000000000000000
0000000000000000000000022000000000000000
0000000000000000022222222222220000000000
0000000000000000222222222222222222200000
0000000022200022222222222222222222200000
0000002222220222222211111111222222200000
0000022222222222221111111111112222200000
0000222222222222111111111111111122000000
2222222111222111111111111111111122222000
2221111111211111111111111111111112222200
2221111111111111111111111111111112222200
1111111111111111111111111111111111222200
1111111111111111111111111111111111222000
1111111111111111111111111111111111222200
1111111111111111111111111111111112222000
1111111111111111111111111111111112220000
1111111111111111111111111111111111222000
1111111111111111111111111111111111220000
1111111111111111111111111111111111200000
1111111111111111111111111111111112222000
1111111111111111111111111111111122220000
1111111111111111111111111111111122222000
1111111111111111111111111111111112220000
1111111111111111111111111111111112200000
1111111111111111111111111111111111222000
1111111111111111111111111111111111220000
1111111111111111111111111111111111222000
1111111111111111111111111111111112220000
1111111111111111111111111111111112200000
1111111111111111111111111111111122222000
1111111111111111111111111111111122220000
1111111111111111111111111111111222222000
1111111111111111111111111111122222220000
1111111111122221111111222222222222200000
1122222222222222222222222222222220000000
2222222222222222222222222222200000000000
2222222200000000000000000000000000000000
0000000000000000000000000000000000000000
0000000000000000000000000000000000000000
0000000000000000000000000000000000000000
