1111111111111111111111111222222222222200
1111111111111111111111111222222222000000
1111111111111111112222222222222220000000
1111111111111111112222222222222220000000
1111111111111111112222222222222200000000
1111111111111111122220000000000000000000
1111111111111111122220000000000000000000
1111111111111111222200000000000000000000
1111111111111112222200000000000000000000
1111111111111112222000000000000000000222
1111111111111112222000000000000000002222
1111111111111122220000000000000000022222
1111111111111122220000000000000000222222
1111111111111222200000000000000000221111
1111111111112222200000000000000002221111
1111111111122222200000000000222222221111
1111111111222222000000000002222222111111
1111111111222200000000000002211121111111
1111111111222000000000000022211111111111
1111111111222000000000000022211111111111
1111111111222000000000000022211111111111
1111111112222000000000000002211111111111
1111111122222000000000000002211111111111
1111111222220000000000000002221111111111
1111111222200000000000000002221111111111
1111111222000000000000000000222111111111
1111111222000000000000022222222111111111
1111111222000000000000222222111111111111
1111112222000000000000221111111111111111
1111122222000000000000221111111111111111
1112222222000000000000221111111111111111
2222222200000000000000222111111111111111
2222222000000000000000022221111111111111
2222000000000000000000002222211111111111
2222000000000000000000000222222222222111
2222000000000000000000000022222222222111
0000000000000000000000000000222222222222
0000000000000000000000000000000000000000
0000000000000000000000000000000000000000
0000000000000000000000000000000000000000