22222222222222222222
22222222222222222222
22222222222222222222
22222222222222222222
22222222222222222222
22222222222222222222
22222222222222222211
22222222222222221111
22222221112221111111
22211111112111111111
22211111111111111111
11111111111111111111
11111111111111111111
11111111111111111111
11111111111111111111
11111111111111111111
11111111111111111111
11111111111111111111
11111111111111111111
11111111111111111111
